1
20 9
1
14 1 4 7
XXXXXXXXXXXXXXXXXXXX
XXXXX..........XXXXX
XXXX...........XXXXX
XXXX.....X.....XXXXX
XXXXXX.........XXXXX
XXXX...........XXXXX
XXXX....X......XXXXX
XXXX....X.....XXXXXX
XXXXXXXXXXXXXXXXXXXX