1
20 9
2
14 1 4 7
14 2 4 5
XXXXXXXXXXXXXXXXXXXX
XXXXX..........XXXXX
XXXX...........XXXXX
XXXX.....X.....XXXXX
XXXXXX.........XXXXX
XXXX...........XXXXX
XXXX....X......XXXXX
XXXX....X.....XXXXXX
XXXXXXXXXXXXXXXXXXXX