XXXXXXXXXXXXXXXXXXXX
XXXX    A  L   XXXXX
XXXX           XXXXX
XXXX           XXXXX
XXXX           XXXXX
XXXX           XXXXX
XXXX           XXXXX
XXXX   a   l   XXXXX
XXXXXXXXXXXXXXXXXXXX
END