20 9
XXXXXXXXXXXXXXXXXXXX
XXXX           XXXXX
XXXX           XXXXX
XXXX           XXXXX
XXXX           XXXXX
XXXX           XXXXX
XXXX           XXXXX
XXXX   a   l   XXXXX
XXXXXXXXXXXXXXXXXXXX